...#####
..#....#
.#.....#
#.....@#
#......#
.#.....#
..#....#
...#####