............#............
...........#.#...........
.........#....#..........
........#......#.........
.......#........#........
......#..........#.......
.....#............#......
....#..............#.....
...#................#....
..#..................#...
.#.....................#.
#.......................#
#.......................#
.#.....................#.
..#..................#...
...#................#....
....#..............#.....
.....#............#......
......#..........#.......
.......#........#........
........#......#.........
.........#....#..........
...........#.#...........
............#............